10
9
0000000000
0011011000
0011011000
0000000000
0110000110
0110000110
0000110000
0000110000
0000000000
