10
10
0000000000
0000000000
0000001000
0001001000
0011000000
0011000111
0000000111
0000000000
0110010000
0110000000
